background=background.jpg
555555555555555555555555555555555
555555555555555555555555555555555
999999999999999999999999999999999
                                 
								 
								 
								 
								 
								 
111111111111111111111111111111111
555555555555555555555555555555555
555555555555555555555555555555555